SUZ12_PlusTag_CLIP	SUZ12_PlusTag_Input
SUZ12_PlusTag_CLAP	SUZ12_PlusTag_Input
SUZ12_MinusTag_CLIP	SUZ12_MinusTag_Input
SUZ12_MinusTag_CLAP	SUZ12_MinusTag_Input
SAFA_PlusTag_CLIP	SAFA_PlusTag_Input
SAFA_PlusTag_CLAP	SAFA_PlusTag_Input
SAFA_MinusTag_CLIP	SAFA_MinusTag_Input
PTBP1_PlusTag_CLIP	PTBP1_PlusTag_Input
PTBP1_PlusTag_CLAP	PTBP1_PlusTag_Input
PTBP1_MinusTag_CLIP	PTBP1_MinusTag_Input
GFP_PlusTag_CLIP	GFP_PlusTag_Input
GFP_PlusTag_CLAP	GFP_PlusTag_Input
EZH2_PlusTag_CLIP	EZH2_PlusTag_Input
EZH2_PlusTag_CLAP	EZH2_PlusTag_Input
EZH2_MinusTag_CLIP	EZH2_MinusTag_Input
EZH2_MinusTag_CLAP	EZH2_MinusTag_Input
EED_PlusTag_CLIP	EED_PlusTag_Input
EED_PlusTag_CLAP	EED_PlusTag_Input
EED_MinusTag_CLIP	EED_MinusTag_Input
EED_MinusTag_CLAP	EED_MinusTag_Input
PTBP1_MinusTag_CLAP	PTBP1_MinusTag_Input
SAFA_MinusTag_CLAP	SAFA_MinusTag_Input
